
Stage.cpp


#include "DxLib.h"
#include "stage.h"

int chipImage[7];
int matiImage[43];
int tougizyouImage[12];
int yamaImage[23];

XY mapSize;

int map1[MAP_Y][MAP_X] = {
{0,0,0,0 ,0,0,0,0 ,0,0,0,0 ,0,0,0,0 ,0,0,0,0,},
{13,14,8,8 ,8,8,8,8 ,11,13,14,8 ,8,13,14,8 ,8,8,8,8,},
{9,10,8,8 ,8,8,8,9 ,17,10,8,8 ,8,8,8,8 ,13,14,8,8,},
{5,5,3,8 ,19,4,2,5 ,5,5,3,8 ,8,2,3,4 ,8,8,8,8,},

{5,5,5,3 ,2,5,5,5 ,5,5,5,3 ,2,5,5,5 ,3,4,4,2,},
{12,12,12,12 ,12,12,12,12 ,12,12,12,12 ,12,12,12,12 ,12,12,12,12,},
{16,16,16,16 ,16,16,16,16 ,16,16,16,16 ,16,16,16,16 ,16,16,16,16,},
{16,16,16,16 ,16,16,16,16 ,20,21,21,22 ,16,16,16,16 ,16,16,16,16,},

{6,6,6,6 ,6,6,6,6 ,6,6,6,6 ,6,6,6,6 ,6,6,6,6,},
{7,6,6,6 ,20,22,6,6 ,7,7,7,7 ,6,6,20,22 ,7,7,7,7,},
{15,15,15,15 ,15,15,15,15 ,15,15,15,15 ,15,15,15,15 ,15,15,15,15,},
{1,1,1,1 ,1,1,1,1 ,1,1,1,1 ,1,1,1,1 ,1,1,1,1,},
};
int maphamaguri[MAP_Y][MAP_X] = {
{2,0,0,0 ,1,0,0,1 ,0,0,0,0 ,1,0,0,1 ,0,0,0,3,},
{2,0,0,0 ,1,0,0,1 ,0,0,0,0 ,1,0,0,1 ,0,0,0,3,},
{2,0,0,0 ,1,0,0,1 ,0,0,0,0 ,1,0,0,1 ,0,0,0,3,},
{2,0,0,0 ,1,0,0,1 ,0,0,0,0 ,1,0,0,1 ,0,0,0,3,},

{2,0,0,0 ,1,0,0,1 ,0,0,0,0 ,1,0,0,1 ,0,0,0,3,},
{2,0,0,0 ,1,0,0,1 ,0,0,0,0 ,1,0,0,1 ,0,0,0,3,},
{2,0,0,0 ,1,0,0,1 ,0,0,0,0 ,1,0,0,1 ,0,0,0,3,},
{2,0,0,0 ,1,0,0,1 ,0,0,0,0 ,1,0,0,1 ,0,0,0,3,},

{2,0,0,0 ,1,0,0,1 ,0,0,0,0 ,1,0,0,1 ,0,0,0,3,},
{2,0,0,0 ,1,0,0,1 ,0,0,0,0 ,1,0,0,1 ,0,0,0,3,},
{2,0,0,0 ,1,0,0,1 ,0,0,0,0 ,1,0,0,1 ,0,0,0,3,},
{6,6,6,6 ,6,6,6,6 ,6,6,6,6 ,6,6,6,6 ,6,6,6,6,},
};
int mapmati[MAP_Y][MAP_X] = {
{16,16,16,16 ,16,16,16,16 ,16,16,16,16 ,16,16,16,16 ,16,16,16,16,},
{19,19,19,19 ,19,19,19,19 ,20,21,19,19 ,19,19,19,19 ,19,19,19,19,},
{19,20,21,19 ,19,19,19,19 ,19,19,19,19 ,19,20,21,19 ,19,19,19,19,},
{19,19,19,19 ,19,20,21,19 ,19,19,19,40 ,19,19,19,19 ,19,19,19,19,},

{19,19,19,19 ,19,19,19,19 ,19,19,40,19 ,19,19,19,19 ,20,21,19,19,},
{40,19,19,19 ,19,39,19,19 ,19,19,19,40 ,19,20,21,19 ,19,19,39,19,},
{35,35,35,35 ,35,38,35,35 ,35,36,37,35 ,35,35,35,35 ,35,35,38,35,},
{12,11,11,13 ,4,3,3,5 ,33,41,42,34 ,12,11,11,13 ,4,3,3,5,},

{9,9,9,9 ,1,1,1,1 ,17,31,32,17 ,9,9,9,9 ,1,1,1,1,},
{9,10,15,9 ,1,2,7,1 ,27,28,29,30 ,9,10,15,9 ,1,2,7,1,},
{9,9,14,9 ,1,1,6,1 ,24,25,25,26 ,9,9,14,9 ,1,1,6,1,},
{0,0,0,0 ,0,0,0,0 ,0,0,0,0 ,0,0,0,0 ,0,0,0,0,},
};
int maptougi[MAP_Y][MAP_X] = {
{10,4,4,10 ,10,4,4,10 ,10,4,4,10 ,10,4,4,10 ,10,4,4,10,},
{11,11,11,11 ,11,11,11,11 ,11,11,11,11 ,11,11,11,11 ,11,11,11,11,},
{3,4,4,9 ,9,4,4,3 ,9,4,4,9 ,3,4,4,9 ,9,4,4,3,},
{2,4,4,10 ,10,4,4,2 ,10,4,4,10 ,2,4,4,10 ,10,4,4,2,},

{5,6,6,6 ,6,6,6,5 ,6,6,6,6 ,5,6,6,6 ,6,6,6,5,},
{5,8,8,8 ,8,8,8,5 ,8,8,8,8 ,5,8,8,8 ,8,8,8,5,},
{5,8,8,8 ,8,8,8,5 ,8,8,8,8 ,5,8,8,8 ,8,8,8,5,},
{5,8,8,8 ,8,8,8,5 ,8,8,8,8 ,5,8,8,8 ,8,8,8,5,},

{1,1,1,1 ,1,1,1,1 ,1,1,1,1 ,1,1,1,1 ,1,1,1,1,},
{0,0,0,0 ,0,0,0,0 ,0,0,0,0 ,0,0,0,0 ,0,0,0,0,},
{0,0,0,0 ,0,0,0,0 ,0,0,0,0 ,0,0,0,0 ,0,0,0,0,},
{7,7,7,7 ,7,7,7,7 ,7,7,7,7 ,7,7,7,7 ,7,7,7,7,},
};
int WINAPI WinMain(HINSTANCE, HINSTANCE, LPSTR, int)
{

	if (!SysInit())
	{
		return 0;
	}
	// 描画対象グラフィックを作成


	// ｹﾞｰﾑﾙｰﾌﾟ
	//-------------------------
	while (ProcessMessage() == 0 && CheckHitKey(KEY_INPUT_ESCAPE) == 0)
	{
		

		ScreenFlip();
	}
	DxLib_End();
	return 0;
}

// ｼｽﾃﾑ処理
//-------------------------
bool SysInit(void)
{
	bool rtnFlag = true;
	// ｼｽﾃﾑ処理
	//---------------------
	SetWindowText("BaseProject");
	// ｼｽﾃﾑ処理
	SetGraphMode(SCREEN_SIZE_X, SCREEN_SIZE_Y, 16); // 800×600ﾄﾞｯﾄ65536色ﾓｰﾄﾞに設定
	ChangeWindowMode(true);							// true:Window false:ﾌﾙｽｸﾘｰﾝ
	if (DxLib_Init() == -1)							// DXﾗｲﾌﾞﾗﾘ初期化処理
	{
		return -1;
	}
	SetDrawScreen(DX_SCREEN_BACK);					// ひとまずﾊﾞｯｸﾊﾞｯﾌｧに描画

	


	// ------ｸﾞﾗﾌｨｯｸの登録------
	LoadDivGraph("image/hamaguriroom.png", 7, 7, 1, CHIP_SIZE_X, CHIP_SIZE_Y, chipImage, false);
	LoadDivGraph("image/mati.png", 43, 43, 1, CHIP_SIZE_X, CHIP_SIZE_Y, matiImage, false);
	LoadDivGraph("image/tougizyou.png", 12, 12, 1, CHIP_SIZE_X, CHIP_SIZE_Y, tougizyouImage, false);
	LoadDivGraph("image/yama.png", 23, 23, 1, CHIP_SIZE_X, CHIP_SIZE_Y, yamaImage, false);
	// ------変数初期化------
	StageSysInit();
	return rtnFlag;
}

void StageSysInit(void)
{
	mapSize.x = MAP_X;
	mapSize.y = MAP_Y;
	StageGameInit();
}
void StageGameInit(void)
{
	StageDraw();
}

void StageDraw(void)
{
	for (int y = 0; y<mapSize.y;y++)
	{
		for(int x = 0; x < mapSize.x; x++)
		{
			DrawGraph(x*CHIP_SIZE_X, y*CHIP_SIZE_Y, matiImage[mapmati[y][x]], true);
		}
	}
}


Stage.h

#define SCREEN_SIZE_X 1000		//画面の横ｻｲｽﾞ
#define SCREEN_SIZE_Y 600		//画面の縦ｻｲｽﾞ

#define MAP_X 20
#define MAP_Y 12
#define CHIP_SIZE_X 50
#define CHIP_SIZE_Y 50


struct XY
{
	int x;
	int y;
};

bool SysInit();

void StageSysInit(void);

void StageGameInit(void);

void StageDraw(void);

